+-+-+-+-+-+
S |       |
+ +-+-+ + +
| |     | |
+ + + + + +
|   | |   |
+-+-+ + +-+
|     |   |
+ + +-+ + +
| |     | E
+-+-+-+-+-+