+-+-+-+-+-+
S |       |
+ +-+-+ + +
| |     | |
+ + + + + +
|   | |   |
+-+-+ +-+-+
|     |  T|
+ + +-+ +-+
| |     |TE
+-+-+-+-+-+

+-+-+-+-+-+
|         |
+         +
|         |
+         +
|         |
+         +
|        T|
+         +
|        T|
+-+-+-+-+-+